%%%%%%%%%
% P     %
% %.%G%%%  
%     %%%
%%%%%%%%%
