%%%%%%%%%%%%%%%%%%%%
%    %        %  . %
% %% % %%  %% % %% %
% %     %  %     % %
% % %% %%  %% %% % %
%          G% %    %
% %    %%%%%% %  % %
% %    %    % %  % %
% %    % %%%% %  % %
% %           %  % %
% %% % %%%%%% % %% %
%    %   P    %    %
%%%%%%%%%%%%%%%%%%%%
