%%%%%%%%
%     P%
% %%%%%%
%   .  %
%%%%%%%%
